###################################################################################################
#                                                                                                 #
#         #                                                                      #                #
#       ###                                          #                      ######                #
###########      ###                                ####                   #######              ###
###########    ########                     #############                #########   ##############
###########  ##############              ######################       #############################
#############################           ###########################################################
#############################          ############################################################
#############################         #############################################################
#############################        ##############################################################
###################################################################################################